# Base
REB = "countries/Rebels.txt"
PIR = "countries/Pirates.txt"
NAT = "countries/Natives.txt"

#-----------------------------------------
# Southwest Commonwealth
#-----------------------------------------
# South California, Nevada

NCR = "countries/NCR - New California Republic.txt"
FOA = "countries/FOA - Followers of the Apocalypse.txt" 
TUB = "countries/TUB - The Hub.txt"         
JNK = "countries/JNK - Junktown.txt"
NRN = "countries/NRN - New Reno.txt"    
SHA = "countries/SHA - Shady Sands.txt"  
MXS = "countries/MXS - Maxson.txt"          
DYS = "countries/DYS - Dayglow.txt"         
BUL = "countries/BUL - Bullhead.txt"    
CAM = "countries/CAM - Camp McCarren.txt"  
NAV = "countries/NAV - Navarro.txt"         
SAC = "countries/SAC - Sac-Town.txt"        
RED = "countries/RED - Redding.txt"         
ONE = "countries/ONE - One Pine.txt"        
HAT = "countries/HAT - Hawthorne.txt"       
BIT = "countries/BIT - Bitterwater.txt"   
VLJ = "countries/VLJ - Vallejo.txt"         
MED = "countries/MED - Mendocino.txt"       
GRP = "countries/GRP - Granite Peak.txt"    
ELK = "countries/ELK - Elko.txt"            
WHT = "countries/WHT - Whitehorn.txt"   
NAI = "countries/NAI - Nail.txt"            
LAS = "countries/LAS - Lassen.txt"          
VIS = "countries/VIS - Visalia.txt"         
FRS = "countries/FRS - Fresno.txt"          
MER = "countries/MER - Merced.txt"          
MND = "countries/MND - Mendota.txt"         
FLT = "countries/FLT - The Flats.txt"       
TAH = "countries/TAH - Tahoe.txt"     
VID = "countries/VID - Vidal.txt"
SLB = "countries/SLB - Slab.txt"
BOG = "countries/BOG - Borrego.txt"
QUZ = "countries/QUZ - Quartz.txt"
BIP = "countries/BIP - Big Pine.txt"
SCH = "countries/SCH - Scrapheap.txt"

BOS = "countries/BOS - Lost Hills Chapter.txt"
NEC = "countries/NEC - Necropolis.txt"
REG = "countries/REG - Regulators.txt"
NVG = "countries/NVG - New Vegas.txt"    
BOO = "countries/BOO - Boomers.txt"
JAC = "countries/JAC - Jacobstown.txt"
GDS = "countries/GDS - Goodsprings.txt"
GRK = "countries/GRK - Great Khans.txt" 
GEC = "countries/GEC - Gecko.txt" 
VAU = "countries/VAU - Vault City.txt"
SKY = "countries/SKY - Skynet.txt"
RNC = "countries/RNC - Renewal Cult.txt" 
PRI = "countries/PRI - Primm.txt"
FIE = "countries/FIE - Fiends.txt"
SOU = "countries/SOU - State of Utobitha.txt"
POW = "countries/POW - Powder Gangers.txt"
TKG = "countries/TKG - The Kings.txt"                 
WSS = "countries/WSS - Westside.txt"
MCT = "countries/MCT - Mojave Chapter.txt" 
GD1 = "countries/GD1 - Californian Marked Men.txt"
GD2 = "countries/GD2 - Legionary Marked Men.txt"
POC = "countries/POC - Convict Revolutionaries.txt"
SLN = "countries/SLN - Sloan.txt"
YAK = "countries/YAK - Yakuza.txt"              
BBR = "countries/BBR - Bright Brotherhood.txt"
NOV = "countries/NOV - Novac.txt"
LPN = "countries/LPN - Lo Pan.txt"
SHI = "countries/SHI - Shi.txt"     
VBO = "countries/VBO - Chinatown Chapter.txt"
DEN = "countries/DEN - The Den.txt"
MOD = "countries/MOD - Modoc.txt"
VB1 = "countries/VB1 - Den Chapter.txt"
TPT = "countries/TPT - Trapper Town.txt"
ARR = "countries/ARR - Arroyo.txt"
HUB = "countries/HUB - Hubologists.txt"
MAR = "countries/MAR - Mariposa.txt"
VIP = "countries/VIP - Vipers.txt"

#-----------------------------------------
# Northwest Commonwealth
#-----------------------------------------
# Oregon, Idaho, Washington

BBN = "countries/BBN - Blackbones.txt"      
WSK = "countries/WSK - Whitestalkers.txt"   
CKF = "countries/CKF - Cracked Fist.txt"    
LTT = "countries/LTT - Lost Totem.txt"      
DMT = "countries/DMT - Deadmouth.txt"       
ISS = "countries/ISS - Issaquah.txt"      

# None of the history files have been implemented for the new countries yet
# LSS = "countries/LSS - Lasso.txt" # Lasso         - tech_wastelander - frontier_settlement_reform - lasso - secular
# RDW = "countries/RDW - Redwood.txt" # Redwood       - tech_wastelander - frontier_settlement_reform - redwood - secular
# FRM = "countries/FRM - Fremontia.txt" # Fremontia     - tech_wastelander - mercantile_settlement_reform - fremontia - secular
# BOD = "countries/BOD - Boulder Dome.txt" # Boulder Dome  - tech_wastelander - militarized_settlement_reform - boulder_dome - secular
# RSB = "countries/RSB - Rustbucket.txt" # Rustbucket    - tech_raider - raider_reform - rustbucket - tribalism
# WIC = "countries/WIC - Withered Claw.txt" # Withered Claw - tech_tribal - tribe_reform - withered_claw - fetishism
# JCK = "countries/JCK - Jackels.txt" # Jackels       - tech_raider - raider_reform - jackel  - tribalism
# MTB = "countries/MTB - Motorboys.txt" # Motorboys     - tech_raider - raider_reform - motorboy - tribalism
# TRT = "countries/TRT - Trinity.txt" # Trinity       - tech_ghoul - mercantile_settlement_reform - trinity - secular
# CRT = "countries/CRT - Crater.txt" # Crater        - tech_super_mutant - super_mutant_reform - crater - tribalism
# TAB = "countries/TAB - The Abbey.txt" # The Abbey     - tech_wastelander - frontier_settlement_reform - abbey - secular

#-----------------------------------------
# Four States Commonwealth
#-----------------------------------------
# Utah, Colorado, Arizona, New Mexico

CAE = "countries/CAE - Caesar's Legion.txt"
CPY = "countries/CPY - Crypts.txt"
CLI = "countries/CLI - Caliente.txt"
DED = "countries/DED - Dead Horses.txt"               
WLS = "countries/WLS - White Legs.txt"                
SOR = "countries/SOR - Sorrows.txt"
EHT = "countries/EHT - Eighties.txt"
PAR = "countries/PAR - Painted Rock.txt"              
CIP = "countries/CIP - Ciphers.txt"
IRR = "countries/IRR - Iron Rivers.txt"               
TWM = "countries/TWM - Twin Mothers.txt"
SCB = "countries/SCB - Scorpions Bite.txt"
MAL = "countries/MAL - Malpais.txt"
DOH = "countries/DOH - Daughters of Hecate.txt"
RES = "countries/RES - Reservation.txt"
BKF = "countries/BKF - Blackfoot.txt"                 
TWH = "countries/TWH - Twisted Hairs.txt"             
FRE = "countries/FRE - Fredonians.txt"                
HAN = "countries/HAN - Hangdogs.txt"                  
HID = "countries/HID - Hidebarks.txt"                 
KAI = "countries/KAI - Kaibabs.txt"                   
RID = "countries/RID - Ridgers.txt"                   
SUN = "countries/SUN - Sun Dogs.txt"

# SOH = "countries/SOH - Scorched Hand.txt" # Scorched Hand     - tech_raider - raider_reform - scorched_hand - tribalism
# NKR = "countries/NKR - Nukaroll.txt" # Nukaroll          - tech_ghoul - tribe_reform - nukaroll - totemism
# TSG = "countries/TSG - Tsegi.txt" # Tsegi             - tech_tribal - tribe_reform - tsegi - animism
# ESC = "countries/ESC - Escali.txt" # Escali            - tech_tribal - tribe_reform - escali - fetishism
# SAD = "countries/SAD - Sandorians.txt" # Sandorians        - tech_raider - raider_reform - sandorian - tribalism
# BKR = "countries/BKR - Blackrot.txt" # Blackrot          - tech_raider - raider_reform - blackrot - tribalism
# RMS = "countries/RMS - Red Mesa.txt" # Red Mesa          - tech_tribal - tribe_reform - red_mesa - animism
# FYS = "countries/FYS - Furystone.txt" # Furystone         - tech_tribal - tribe_reform - furystone - fetishism
# WBR = "countries/WBR - Whitebraid.txt" # Whitebraid        - tech_tribal - tribe_reform - whitebraid - fetishism
# CKT = "countries/CKT - Casktooth.txt" # Casktooth         - tech_tribal - tribe_reform - casktooth - totemism
# RDB = "countries/RDB - Radbite.txt" # Radbite           - tech_ghoul - tribe_reform - radbite - tribalism

#-----------------------------------------
# Great Midwest Commonwealth
#-----------------------------------------
# Minnesota, Wisconsin, Illinois, Indiana and Michigan

BMW = "countries/BMW - Midwest Chapter.txt"       
BRW = "countries/BRW - Brahmin Wood.txt"              
PEO = "countries/PEO - Peoria.txt"
ENC = "countries/ENC - Enclave.txt"
RUS = "countries/RUS - Rust City.txt" 
SOJ = "countries/SOJ - Sons of Jupiter.txt"
BKA = "countries/BKA - Black Arrow.txt"         
BRK = "countries/BRK - Bear Kin.txt"        
BVS = "countries/BVS - Braveshell.txt"          
SKE = "countries/SKE - Snake-ears.txt"          
FGS = "countries/FGS - Fanged Sun.txt"          
WTO = "countries/WTO - Waste Oracles.txt"       
NGH = "countries/NGH - Night Hounds.txt"        
BMM = "countries/BMM - Broken Hammer.txt"           
GHH = "countries/GHH - Ghoul Haters.txt"

# HVL = "countries/HVL - Hovel.txt" # Hovel                 - tech_tribal - tribe_reform - hovel - tribalism
# DRH = "countries/DRH - Dirt Haven.txt" # Dirt Haven            - tech_tribal - tribe_reform - dirt_haven - animism
# IKT = "countries/IKT - Ikthan.txt" # Ikthan                - tech_raider - raider_reform - ikthan - tribalism
# RVM = "countries/RVM - Reaver Movement.txt" # Reaver Movement       - tech_raider - raider_reform - reaver - tribalism
# BSL = "countries/BSL - Beastlords.txt" # Beastlords            - tech_tribal - tribe_reform - beastlord - animism
# TCO = "countries/TCO - The Corpse.txt" # The Corpse            - tech_raider - raider_reform - corpse - tribalism
# GMR = "countries/GMR - Gammorin's Remnants.txt" # Gammorin's Remnants   - tech_super_mutant - super_mutant_reform - gammorin - tribalism
# INC = "countries/INC - Indiana Chapter.txt" # Indiana Chapter       - tech_bos - brotherhood_reform - indiana_chapter - creatorism
# MNC = "countries/MNC - Minnesota Chapter.txt" # Minnesota Chapter     - tech_bos - brotherhood_reform - minnesota_chapter - creatorism

#-----------------------------------------
# Plains Commonwealth     
#-----------------------------------------
# Iowa, Missouri, Kansas, Oklahoma and Nebraska      
   
MAC = "countries/MAC - Macomb.txt"                    
GRA = "countries/GRA - Gravestone.txt"                
JUN = "countries/JUN - Junction City.txt"             
COL = "countries/COL - Coldwater.txt"
TMF = "countries/TMF - The Main Faction.txt"
GDG = "countries/GDG - Gang of Devil's Graveyard.txt" 
GOM = "countries/GOM - Gang of Macomb.txt"
GMA = "countries/GMA - Gammorin's Army.txt"
GMF = "countries/GMF - Grimfoot.txt"            
WHC = "countries/WHC - Wheatclaw.txt"           
BSK = "countries/BSK - Bonespike.txt"           
RPC = "countries/RPC - Ripclaw.txt"             
LSH = "countries/LSH - Lashers.txt"             
CWG = "countries/CWG - Crowgrave.txt"           
CMS = "countries/CMS - Crimson Sons.txt"        
TFL = "countries/TFL - Thunderfalls.txt"        
DRV = "countries/DRV - Dirtvale.txt"            
CYE = "countries/CYE - Coyote Eyes.txt"     

# APP = "countries/APP - Appleton.txt" # Appleton          - tech_wastelander - frontier_settlement_reform - appleton - secular
# SPF = "countries/SPF - Springfield.txt" # Springfield       - tech_wastelander - frontier_settlement_reform - springfield - secular
# RST = "countries/RST - Red Stingers.txt" # Red Stingers      - tech_raider - raider_reform - red_stinger - tribalism
# VIG = "countries/VIG - Vinchenzo Gang.txt" # Vinchenzo Gang    - tech_raider - raider_reform - vinchenzo - tribalism

#-----------------------------------------
# Columbia Commonwealth
#-----------------------------------------
# Virginia, Maryland, Washington DC

BEC = "countries/BEC - East Coast Chapter.txt"   
RIV = "countries/RIV - Rivet City.txt"                
MEG = "countries/MEG - Megaton.txt"                   
PLO = "countries/PLO - Point Lookout.txt"
BIG = "countries/BIG - Big Town.txt"
FAM = "countries/FAM - The Family.txt"
CRM = "countries/CRM - Chinese Remnant.txt"
V11 = "countries/V11 - Vault 101.txt"
ABR = "countries/ABR - Abbey of the Road.txt"
BRO = "countries/BRO - Brotherhood Outcasts.txt"
LLL = "countries/LLL - Little Lamplight.txt"
PAF = "countries/PAF - Paradise Falls.txt"            
RPD = "countries/RPD - Republic of Dave.txt"          
GER = "countries/GER - Germantown.txt"                
SPV = "countries/SPV - Springvale.txt"                
ANL = "countries/ANL - Andale.txt"                    
TEN = "countries/TEN - Tenpenny.txt"                  
UND = "countries/UND - Underworld.txt"
ARE = "countries/ARE - Arefu.txt"
OAS = "countries/OAS - Oasis.txt"
TOU = "countries/TOU - Temple of the Union.txt"       
CCM = "countries/CCM - Canterbury Commons.txt"
WTN = "countries/WTN - Warrington.txt" 

#-----------------------------------------
# New England Commonwealth
#-----------------------------------------
# Maine, New Hampshire, Vermont, Massachusetts, Rhode Island and Connecticut
INS = "countries/INS - The Institute.txt"             
MEC = "countries/MEC - Mechanist.txt"                 
TRG = "countries/TRG - Triggermen.txt"                
USC = "countries/USC - USS Constitution.txt"          
HTW = "countries/HTW - Hardware Town.txt"             
COV = "countries/COV - Covenant.txt"
RRD = "countries/RRD - The Railroad.txt"              
MTM = "countries/MTM - The Minutemen.txt"
ATC = "countries/ATC - Atom Cats.txt"
GUN = "countries/GUN - Gunners.txt"  
DIC = "countries/DIA - Diamond City.txt"                           
BOC = "countries/BOC - Boston Chapter.txt"       
COA = "countries/COA - Children of the Atom.txt"    
GNB = "countries/GNB - Goodneighbour.txt"
FRG = "countries/FRG - Forged.txt"
V81 = "countries/V81 - Vault 81.txt"
SLG = "countries/SLG - Slag.txt"   
BKH = "countries/BKH - Bunker Hill.txt"

# KIS = "countries/KIS - Kalissa.txt" # Kalissa       - tech_wastelander - frontier_settlement_reform - kalissa - secular
# EDE = "countries/EDE - Eden.txt" # Eden          - tech_wastelander - mercantile_settlement_reform - eden - secular
# WOS = "countries/WOS - Woodstock.txt" # Woodstock     - tech_wastelander - frontier_settlement_reform - woodstock - secular
# TSF = "countries/TSF - Rustfang.txt" # Rustfang      - tech_raider - raider_reform - rustfang - tribalism
# RAI = "countries/RAI - Railspike.txt" # Railspike     - tech_raider - raider_reform - railspike - tribalism
# SKP = "countries/SKP - Spiked Palm.txt" # Spiked Palm   - tech_tribal - tribe_reform - spiked_palm - fetishism 
# GWV = "countries/GWV - Golden Wolves.txt" # Golden Wolves - tech_tribal - tribe_reform - golden_wolves - animism
# SML = "countries/SML - Smoulder.txt" # Smoulder      - tech_tribal - tribe_reform - smoulder - fetishism

#-----------------------------------------
# Eastern Commonwealth
#-----------------------------------------
# Pennsylvania, New York, Delaware, New Jersey and West Virginia

PIT = "countries/PIT - The Pitt.txt"
NYC = "countries/NYC - New New York.txt"
GLA = "countries/GLA - Great Lanta.txt"
MON = "countries/MON - Monroeville.txt"
TPK = "countries/TPK - The Pack.txt"      
DIS = "countries/DIS - Disciples.txt"     
OPT = "countries/OPT - Operators.txt"     
NUK = "countries/NUK - Nuka-Hub.txt"
NWD = "countries/NWD - Nuka-World.txt"
IRB = "countries/IRB - Ironbow.txt"         
HWT = "countries/HWT - Hawktalon.txt"       
EBC = "countries/EBC - Eboncaste.txt"       

# DEL = "countries/DEL - Delphia.txt" # Delphia               - tech_wastelander - frontier_settlement_reform - delphia - secular
# TIO = "countries/TIO - Tioga.txt" # Tioga                 - tech_tribal - tribe_reform - tioga - tribalism
# NFF = "countries/NFF - New Frankfurt.txt" # New Frankfurt         - tech_wastelander - militarized_settlement_reform - frankfurt - secular
# OVB = "countries/OVB - Overburg.txt" # Overburg              - tech_wastelander - mercantile_settlement_reform - overburg - secular
# ALT = "countries/ALT - Altoona.txt" # Altoona               - tech_wastelander - frontier_settlement_reform - altoona - secular
# BOT = "countries/BOT - Bothi.txt" # Bothi                 - tech_tribal - tribe_reform - bothi - animism
# YOK = "countries/YOK - Yokmuth.txt" # Yokmuth               - tech_wastelander - militarized_settlement_reform - yokmuth - secular
# WND = "countries/WND - Windmore.txt" # Windmore              - tech_wastelander - mercantile_settlement_reform - windmore - secular
# HAV = "countries/HAV - Haven.txt" # Haven                 - tech_tribal - tribe_reform - haven - tribalism

#-----------------------------------------
# Texas Commonwealth
#-----------------------------------------
# Texas and Arkansas

AUS = "countries/AUS - Austin.txt"
LUB = "countries/LUB - Lubbock.txt"         
LNS = "countries/LNS - Lone Star.txt"
BTX = "countries/BTX - Texas Chapter.txt"   
CZH = "countries/CZH - Crazy Horns.txt"     
SRS = "countries/SRS - Scarred Sun.txt"     
IRO = "countries/IRO - Ironbask.txt"        
ATF = "countries/ATF - Atomicflare.txt"     
SOL = "countries/SOL - Sol.txt"             
BCB = "countries/BCB - Bleached Bones.txt"  
RCA = "countries/RCA - Red Scar.txt"        
FMF = "countries/FMF - Flamefoot.txt"        
GHR = "countries/GHR - Ghoulroad.txt"        
SSP = "countries/SSP - Steel Scorpions.txt" 

# DAL = "countries/DAL - Dallas.txt" # Dallas                    - tech_wastelander - militarized_settlement_reform - dallas - secular
# KTC = "countries/KTC - Kisatchie.txt" # Kisatchie                 - tech_tribal - tribe_reform - kisatchie - totemism
# DOC = "countries/DOC - Doch.txt" # Doch                      - tech_tribal - tribe_reform - doch - totemism
# CON = "countries/CON - Church of Nuka.txt" # Church of Nuka            - tech_children_of_the_atom - cult_reform - children_of_the_atom - atomic_worship
# AMA = "countries/AMA - Amaril.txt" # Amaril                    - tech_wastelander - frontier_settlement_reform - amaril - secular
# OKL = "countries/OKL - Oklama.txt" # Oklama                    - tech_wastelander - frontier_settlement_reform - oklama - secular
# RUW = "countries/RUW - Rustworth.txt" # Rustworth                 - tech_wastelander - militarized_settlement_reform - rustworth - secular
# SHT = "countries/SHT - Shattered Eye.txt" # Shattered Eye             - tech_raider - raider_reform - shattered_eye - tribalism
# TUL = "countries/TUL - Tul Gator.txt" # Tul Gator                 - tech_raider - raider_reform - tul_gator - tribalism
# KIL = "countries/KIL - Killred.txt" # Killred                   - tech_raider - raider_reform - killred - tribalism
# ZAK = "countries/ZAK - Zark.txt" # Zark                      - tech_super_mutant - super_mutant_reform - zark - tribalism
# COS = "countries/COS - Confederation of Soot.txt" # Confederation of Soot     - tech_raider - raider_reform - soot - tribalism
# PAM = "countries/PAM - Pamipa.txt" # Pamipa                    - tech_tribal - tribe_reform - pamipa - animism
# TEX = "countries/TEX - Texak.txt" # Texak                     - tech_raider - raider_reform - texak - tribalism
# ASH = "countries/ASH - The Ashen.txt" # The Ashen                 - tech_ghoul - militarized_settlement_reform - ashen - secular
# SLT = "countries/SLT - Saltlicks.txt" # Saltlicks                 - tech_raider - raider_reform - saltlicks - tribalism

#-----------------------------------------
# East Central Commonwealth
#-----------------------------------------
# Ohio, Kentucky and Tennessee

COB = "countries/COB - Cobras.txt" 
IRF = "countries/IRF - Iron Fist.txt" 
SPA = "countries/SPA - Sparta.txt" 

# SIC = "countries/SIC - Sin City.txt" # Sin City          - tech_raider - raider_reform - sinner - tribalism
# TNS = "countries/TNS - The Nashers.txt" # The Nashers       - tech_raider - raider_reform - nasher - tribalism
# NOX = "countries/NOX - Fort Knox.txt" # Fort Knox         - tech_wastelander - militarized_settlement_reform - knox - secular
# YTK = "countries/YTK - Yellowtuck.txt" # Yellowtuck        - tech_tribal - tribe_reform - yellowtuck - totemism
# FUS = "countries/FUS - The Fusion.txt" # The Fusion        - tech_ghoul - frontier_settlement_reform - fusion - secular
# KOK = "countries/KOK - Kokomoro.txt" # Kokomoro          - tech_tribal - tribe_reform - kokomoro - fetishism
# ELH = "countries/ELH - Elkheart.txt" # Elkheart          - tech_tribal - tribe_reform - elkheart - fetishism
# AKR = "countries/AKR - Akron.txt" # Akron             - tech_wastelander - frontier_settlement_reform - akron - secular

#-----------------------------------------
# Northern Commonwealth
#-----------------------------------------
# Montana, Wyoming, North Dakota and South Dakota

BMO = "countries/BMO - Montana Chapter.txt" 
RTS = "countries/RTS - Ratspeakers.txt"     
GMT = "countries/GMT - Grimtooth.txt"       
HAW = "countries/HAW - Moose.txt"

# Continue Country file stuff here
# VOX = "countries/VOX - Vox Populi.txt" # Vox Populi        - tech_caesars_legion - raider_reform - vox_populi - cult_of_mars
# ABE = "countries/ABE - Aberration.txt" # Aberration        - tech_ghoul - raider_reform - aberration - tribalism
# LAW = "countries/LAW - The Lawless.txt" # The Lawless       - tech_raider - raider_reform - lawless - tribalism
# RDI = "countries/RDI - Red Dirt.txt" # Red Dirt          - tech_tribal - tribe_reform - red_dirt - tribalism

#-----------------------------------------
# Gulf Commonwealth
#-----------------------------------------
# Louisiana, Mississippi, Alabama, North Carolina, 
# South Carolina, Georgia and Florida

ATL = "countries/ATL - Atlanta.txt"  
ORL = "countries/ORL - New Orleans.txt"  
SWF = "countries/SWF - Swampfolk.txt"
TAR = "countries/TAR - Tar Walkers.txt"     
SES = "countries/SES - Steel Stalkers.txt"  
LTC = "countries/LTC - Lost Caste.txt"      
GVW = "countries/GVW - Gravewatch.txt"      
NKS = "countries/NKS - Nukaspike.txt"       
DUF = "countries/DUF - Dustfury.txt"        
MKI = "countries/MKI - Murkiron.txt"        
TDG = "countries/TDG - The Degenerates.txt" 

# ARC = "countries/ARC - Arcjet.txt" # Arcjet        - tech_wastelander - militarized_settlement_reform - arcjet - secular
# DOM = "countries/DOM - Freedom.txt" # Freedom       - tech_wastelander - militarized_settlement_reform - freedom - secular
# MDN = "countries/MDN - Malden.txt" # Malden        - tech_wastelander - frontier_settlement_reform - malden - secular
# FLY = "countries/FLY - The Flayed.txt" # The Flayed    - tech_raider - raider_reform - flayed - tribalism
# PIK = "countries/PIK - Pikewood.txt" # Pikewood      - tech_wastelander - frontier_settlement_reform - pikewood - secular
# MDD = "countries/MDD - Mudder.txt" # Mudder        - tech_tribal - tribe_reform - mudder - tribalism
# WDW = "countries/WDW - Wildwood.txt" # Wildwood      - tech_wastelander - frontier_settlement_reform - wildwood - secular
# ATM = "countries/ATM - The Atomics.txt" # The Atomics   - tech_children_of_the_atom - cult_reform - children_of_the_atom - atomic_worship
# FLF = "countries/FLF - Four Leaf.txt" # Four Leaf     - tech_wastelander - mercantile_settlement_reform - four_leaf - secular
# V96 = "countries/V96 - Vault 96.txt" # Vault 96      - tech_vault_dweller - vault_reform - vault_96 - secular

#-----------------------------------------
# Canada
#-----------------------------------------
RON = "countries/RON - Ronto.txt"
CRS = "countries/CRS - Crag Stalkers.txt" 
MOW = "countries/MOW - Men of the Wolf.txt" 
STW = "countries/STW - Stagwalkers.txt" 
REC = "countries/REC - Redclaw.txt" 
SNF = "countries/SNF - Snowfoot.txt" 
HDL = "countries/HDL - Hidelocks.txt" 
SNA = "countries/SNA - Snajan.txt" 

# VIC = "countries/VIC - New Victoria.txt"# New Victoria  - tech_wastelander - frontier_settlement_reform - new_victoria - protestant

#-----------------------------------------
# Mexico
#-----------------------------------------
BAJ = "countries/BAJ - Baja.txt"
DRG = "countries/DRG - Desert Rangers.txt"
MEX = "countries/MEX - Mexico City.txt"
SIN = "countries/SIN - Sinaloa.txt" 
LOZ = "countries/LOZ - Los Zetas.txt" 
BUC = "countries/BUC - Bulwark of Christ.txt" 
PUE = "countries/PUE - Puebla.txt"          
HDG = "countries/HDG - Hidalgo.txt"

# HEM = "countries/HEM - Hemasil.txt"         # tech_wastelander - militarized_settlement_reform - hemasil - catholic
# KIK = "countries/KIK - Kikuakua.txt"        # tech_tribal - tribe_reform - kikuakua - totemism
# VUE = "countries/VUE - Vuevo.txt"           # tech_tribal - tribe_reform - vuevo - totemism
# DUU = "countries/DUU - Duurgo.txt"          # tech_tribal - tribe_reform - duurgo - totemism
# XAL = "countries/XAL - Xalapo.txt"          # tech_raider - raider_reform - xalapo - tribalism
# TAM = "countries/TAM - Tamalpi.txt"         # tech_wastelander - militarized_settlement_reform - tamalpi - catholic
# JAL = "countries/JAL - Jalizo.txt"          # tech_tribal - tribe_reform - jalizo - totemism
# TOX = "countries/TOX - Torrex.txt"          # tech_raider - raider_reform - torrex - tribalism
# PAL = "countries/PAL - Parral.txt"          # tech_wastelander - frontier_settlement_reform - parral - catholic
# MAZ = "countries/MAZ - Mazatli.txt"         # tech_ghoul - raider_reform - mazatli - tribalism
# ZAC = "countries/ZAC - Zaccan.txt"          # tech_raider - raider_reform - zaccan - tribalism
# POJ = "countries/POJ - Potija.txt"          # tech_tribal - tribe_reform - potija - totemism

#-----------------------------------------
# Other
#-----------------------------------------
GHT = "countries/GHT - Ghoul Town.txt"
ROD = "countries/ROD - Rodent Scourge.txt"
TNK = "countries/TNK - Think Tank.txt"                
FBZ = "countries/FBZ - Forbidden Zone.txt"
ZET = "countries/ZET - Zeta.txt"
CUB = "countries/CUB - Cuba.txt"
ST1 = "countries/ST1 - Scavenger Team One.txt"
SIR = "countries/SIR - Sierra Madre.txt"
DTC = "countries/DTC - Deathclaw Cabal.txt"  

#-----------------------------------------
# Formables
#-----------------------------------------
X01 = "countries/X01 - Empire of the Legion.txt"
X02 = "countries/X02 - Shi Empire.txt"
X03 = "countries/X03 - New Californian Empire.txt"
X04 = "countries/X04 - United States.txt"
X05 = "countries/X05 - The Brotherhood.txt"
X06 = "countries/X06 - New Canaan.txt"
X07 = "countries/X07 - Mexico.txt"
X08 = "countries/X08 - Canada.txt"
X09 = "countries/X09 - Zion Confederacy.txt"         
X10 = "countries/X10 - Washington.txt"
X11 = "countries/X11 - Oregon.txt"
X12 = "countries/X12 - California.txt"
X13 = "countries/X13 - Nevada.txt"
X14 = "countries/X14 - Utah.txt"
X15 = "countries/X15 - Idaho.txt"
X16 = "countries/X16 - Montana.txt"
X17 = "countries/X17 - Wyoming.txt"
X18 = "countries/X18 - Baja California.txt"
X19 = "countries/X19 - Arizona.txt"
X20 = "countries/X20 - New Mexico.txt"
X21 = "countries/X21 - Colorado.txt"
X22 = "countries/X22 - North Dakota.txt"
X23 = "countries/X23 - South Dakota.txt"
X24 = "countries/X24 - Nebraska.txt"
X25 = "countries/X25 - Kansas.txt"
X26 = "countries/X26 - Missouri.txt"
X27 = "countries/X27 - Iowa.txt"
X28 = "countries/X28 - Kentucky.txt"
X29 = "countries/X29 - West Virginia.txt"
X30 = "countries/X30 - Ohio.txt"
X31 = "countries/X31 - Indiana.txt"
X32 = "countries/X32 - Michigan.txt"
X33 = "countries/X33 - Minnesota.txt"
X34 = "countries/X34 - Wisconsin.txt"
X35 = "countries/X35 - Illinois.txt"
X36 = "countries/X36 - Oklahoma.txt"
X37 = "countries/X37 - Arkansas.txt"
X38 = "countries/X38 - Texas.txt"
X39 = "countries/X39 - Louisiana.txt"
X40 = "countries/X40 - Mississippi.txt"
X41 = "countries/X41 - Alabama.txt"
X42 = "countries/X42 - Tennessee.txt"
X43 = "countries/X43 - Florida.txt"
X44 = "countries/X44 - Georgia.txt"
X45 = "countries/X45 - South Carolina.txt"
X46 = "countries/X46 - North Carolina.txt"
X47 = "countries/X47 - Virginia.txt"
X48 = "countries/X48 - New York.txt"
X49 = "countries/X49 - New Jersey.txt"
X50 = "countries/X50 - Pennsylvania.txt"
X51 = "countries/X51 - The Capital Wasteland.txt"
X52 = "countries/X52 - The Commonwealth.txt"
X53 = "countries/X53 - British Columbia.txt"
X54 = "countries/X54 - Alberta.txt"
X55 = "countries/X55 - Saskatchewan.txt"
X56 = "countries/X56 - Manitoba.txt"
X57 = "countries/X57 - Ontario.txt"
X58 = "countries/X58 - Quebec.txt"
X59 = "countries/X59 - Newfoundland and Labrador.txt"
X60 = "countries/X60 - New Brunswick.txt"
X61 = "countries/X61 - Nova Scotia.txt"


